##.#.##
#A...B#
##.#.##
#..C..#
##.#.##
#.....#
##.#.##
\robot 1 5
\robot 5 5
\robot 3 3