#######
#A.#.B#
#.....#
#.###.#
#.....#
#######
\robot 1 4
\robot 5 4