########
#A..#.B#
#.####.#
#......#
#.####.#
#C..#.D#
########
\robot 1 5
\robot 6 5
\robot 1 1
\robot 6 1
